##########
#S......E#
#.######.#
#........#
##########